x x x x x x x x x x
x       x         f
x   x       x x x x
x   x x x x       x
x       x x   x   x
x x x   x x   x   x
g   x         x   x
x   x x x x x x   x
x                 x
x x x x x x x x x x
